
##############################
#   #  ###           #       #
#   #           ###  #       #
#   #  ###      ##   #       #
#   ######## #########       #
#   #                #       #
#   #   ######       #       #
#   #       ##       #       #
#   #   ##  ##       #       #
#   #   ######       #       #
#   #                #       #
#   ### ######### ####       #
#   #                #       #
#   #                #       #
#   #                #       #
#   #                #       #
#   #                #       #
#                            #
#   #                #       #
#   #                #       #
#   #                #       #
#   #                #       #
#   ### ######### ####       #
#   #                #       #
#   #  # ###   # #####       #
#   #  #   #   #     #       #
#   ######## #########       #
#   #    #    #      #       #
#   #                #       #
##############################