2
##################################################
#                                                #
#  ##########################  ################  #
#  ##########################  ################  #
#  ##########################  ################  #
#  ##########################  ################  #
#  ##########################   ###############  #
#  ##########################   ###############  #
#  ##########################   ###############  #
#  ##########################   ###############  #
#    ########################   ###############  #
#     #######################  ################  #
#      ######################  ################  #
#  #                           ################  #
#  ##########################  #####      #####  #
#  ##########################                    #
#  ##########################  ########      ##  #
#  ##########################  ################  #
#  ##########################  ################  #
#  ##########################   ###############  #
#  ##########################   ###############  #
#  ##########################   ###############  #
#  ##########################   ###############  #
#  ##########################   ###############  #
#  ##########################   ###############  #
#  ##########################  ################  #
#  ##########################  ################  #
#  ##########################  ################  #
#  ##########################  ################  #
#                                                #
##################################################
